####################################                
#.@................................#################
#..................................|...............#
#..................................|...............#
##--############################################???#
 #..#                                          ?????
 #..#                                               
 #..#                                               
 #..#                                               
 #..#                                               
 #..#                    ###########################
 #..#                    #.........................#
 #..#                    #.........................#
 #..#                    #######################--##
 #..#                                          #..# 
##--#######                                    #..# 
#.........#                      ###############--##
#.........#                      #.................#
#.........#                      #.................#
#.........#                      #.................#
#.........########################.................#
#.........|......................|.................#
#.........########################.................#
###########                      #.................#
                                 #.................#
                       ###########.................#
                       #.........|.................#
                       #.........|.................#
                       #.........###################
                       #....######                  
                       #....#                       
                       #....#                       
                       #....#                       
                       #....#                       
                       #....#                       
                       #....#                       
                       #....#                       
                       #....#                       
                       #----#                       
                       #....#                       
                ########....####                    
                #..............#                    
                #..............#                    
                #..............#                    
                #..............#?                   
                #..............|?                   
                #..............|?                   
                ################?                   