####################################                
#..................................#################
#..................................|...............#
#..................................|..........X....#
##--############################################???#
 #..#                                          ?????
 #..#                                               
 #..#                                               
 #..#                                               
 #..#                                               
 #..#                    ###########################
 #..#                    #.X.......................#
 #..#                    #.........................#
 #..#                    #######################--##
 #..#                                          #..# 
##--#######                                    #..# 
#.........#                      ###############--##
#.........#                      #.................#
#.........#                      #.................#
#.........#                      #.................#
#.........########################.................#
#.........|......................|.................#
#.........########################.................#
###########                      #.................#
                                 #.................#
                       ###########.................#
                       #.........|.................#
                       #.........|.................#
                       #.........###################
                       #....######                  
                       #....#                       
                       #....#                       
                       #....#                       
                       #....#                       
                       #....#                       
                       #....#                       
                       #....#                       
                       #....#                       
                       #----#                       
                       #....#                       
                ########....####                    
                #..............#                    
                #........X.....#                    
                #..............#                    
                #..............#?                   
                #..............|?                   
                #..............|?                   
                ################?                   