####################################
#..................................#
#..................................|
#..................................|
##--################################